ADU = "countries/ADU.txt"
AHE = "countries/AHE.txt" #Austro - Hungarian Empire
ALG = "countries/Algeria.txt"
ALO = "countries/ALO.txt"
ANG = "countries/Angola.txt"
AOG = "countries/AOG.txt"
ARM = "countries/ARM.txt"
AZB = "countries/AZB.txt"
BAS = "countries/BAS.txt"
BAT = "countries/BAT.txt"
BAV = "countries/BAV.txt"
BFA = "countries/Burkina Faso.txt"
BHC = "countries/BHC.txt"
BOM = "countries/Bohemia.txt"
BOS = "countries/Bosnia.txt"
BOT = "countries/Botswana.txt"
BRI = "countries/BRI.txt"
BUR = "countries/BUR.txt"
CAF = "countries/CAF.txt"
CAL = "countries/CAL.txt"
CAM = "countries/CAM.txt"
CAR = "countries/Carlist Spain.txt"
CAT = "countries/CAT.txt"
CEA = "countries/Central Africa.txt"
CEY = "countries/Ceylon.txt"
CGL = "countries/CGL.txt"
CIV = "countries/Cote d'Ivoire.txt"
CNR = "countries/Congo.txt"
CNT = "countries/CNT.txt"
CRE = "countries/Crete.txt"
CSA = "countries/CSA.txt"
CYP = "countries/CYP.txt" #Cyprus
DEH = "countries/DEH.txt"
DKB = "countries/DKB.txt"
DMK = "countries/DMK.txt"
DNF = "countries/DNF.txt" #Danubian Federation
ENP = "countries/ENP.txt"
FLN = "countries/FLN.txt"
FNG = "countries/FNG.txt"
FRP = "countries/Puppet_Neutral_France.txt"
FSA = "countries/FSA.txt"
GAB = "countries/Gabon.txt"
GAL = "countries/GAL.txt"
GBR = "countries/GBR.txt"
GEO = "countries/GEO.txt"
GHA = "countries/Ghana.txt"
GLC = "countries/GLC.txt"
GNE = "countries/GNE.txt"
GRU = "countries/GRU.txt"
HAW = "countries/HAW.txt"
ILL = "countries/ILL.txt"
INC = "countries/Indochina.txt"
INS = "countries/Indonesia.txt"
KAC = "countries/Kachin.txt"
KEN = "countries/Kenya.txt"
KUR = "countries/KUR.txt" #Kurdreich
KYR = "countries/KYR.txt"
LAO = "countries/Laos.txt"
LBR = "countries/LBR.txt"
LEC = "countries/LEC.txt"
LYB = "countries/LYB.txt"
MAD = "countries/MAD.txt"
MAF = "countries/MAF.txt"
MAG = "countries/Madagascar.txt"
MAL = "countries/Mali.txt"
MAN = "countries/MAN.txt" #Great Empire of Manchuria
MLT = "countries/MLT.txt"
MLY = "countries/MLY.txt"
MNS = "countries/Mon State.txt"
MOR = "countries/Morocco.txt"
MOZ = "countries/Mozambique.txt"
MRT = "countries/Mauritania.txt"
MTN = "countries/MTN.txt"
MYS = "countries/MYS.txt" #Mysore
NAM = "countries/Namibia.txt"
NCH = "countries/NCH.txt"
NEE = "countries/NEE.txt"
NER = "countries/Niger.txt"
NFA = "countries/NFA.txt"
NGF = "countries/NGF.txt"
NGR = "countries/Nigeria.txt"
NPA = "countries/NPA.txt" #National Protection Alliance
NRM = "countries/NRM.txt"
OCC = "countries/OCC.txt"
OTT = "countries/OTT.txt"
PHL = "countries/PHL.txt"
PIR = "countries/PIR.txt" #Piratini
PLC = "countries/PLC.txt" #Polish - Lithuan Commonwealth
PNM = "countries/PNM.txt"
PRF = "countries/PRF.txt"
PRI = "countries/PRI.txt"
PSS = "countries/PSS.txt"
QIE = "countries/QIE.txt"
RHI = "countries/RHI.txt"
RKH = "countries/Rakhine.txt"
RRM = "countries/RRM.txt"
RUS = "countries/RUS.txt"
SAR = "countries/Sarawak.txt"
SCA = "countries/SCA.txt"
SCT = "countries/SCT.txt"
SEN = "countries/Senegal.txt"
SHA = "countries/Shan.txt"
SIB = "countries/SIB.txt"
SIE = "countries/Sierra Leone.txt"
SLO = "countries/SLO.txt"
SOM = "countries/Somalia.txt"
SQI = "countries/SQI.txt" #Shanqing
SRI = "countries/SRI.txt"
SUD = "countries/Sudan.txt"
SVK = "countries/Slovakia.txt"
TAI = "countries/Taiwan.txt"
TAJ = "countries/TAJ.txt"
TEX = "countries/TEX.txt"
TIE = "countries/TIE.txt" #Tian Empire
TNZ = "countries/Tanzania.txt"
TRK = "countries/TRK.txt"
TRM = "countries/TRM.txt"
TRV = "countries/TRV.txt" #Travancore
TRS = "countries/Transylvania.txt"
TUA = "countries/TUA.txt"
TUN = "countries/Tunisia.txt"
UGA = "countries/Uganda.txt"
UKR = "countries/UKR.txt"
ULS = "countries/ULS.txt" #Ulster
UZB = "countries/UZB.txt"
VIE = "countries/VIE.txt"
WAD = "countries/Wadai.txt"
WAL = "countries/WAL.txt"
WHR = "countries/WHR.txt"
WLL = "countries/WLL.txt"
ZAM = "countries/Zambia.txt"
ZIM = "countries/Zimbabwe.txt"

#### African Revolters
AZR = "countries/AZR.txt" #Teke
BLR = "countries/BLR.txt" #Bornu
COG = "countries/COG.txt" #Kongo
KAZ = "countries/KAZ.txt" #Kivu League
MZB = "countries/MZB.txt" #Amadawa
MNT = "countries/MNT.txt" #MauMau
PAK = "countries/PAK.txt" #Zanzibar
VIN = "countries/VIN.txt" #Herero Revolt
HAU = "countries/HAU.txt" #Hausland
BRD = "countries/BRD.txt" #Burundi
DAH = "countries/DAH.txt" #Dahomey
TOG = "countries/TOG.txt" #Togoland
KTG = "countries/KTG.txt" #Katanga
MLW = "countries/MLW.txt" #Malawi
RWD = "countries/RWD.txt" #Rwanda
